Median of Two Sorted Arrays	median-of-two-sorted-arrays
Regular Expression Matching	regular-expression-matching
Letter Combinations of a Phone Number	letter-combinations-of-a-phone-number
Valid Parentheses	valid-parentheses
Generate Parentheses	generate-parentheses
Merge k Sorted Lists	merge-k-sorted-lists
Next Permutation	next-permutation
Trapping Rain Water	trapping-rain-water
Wildcard Matching	wildcard-matching
Pow(x, n)	powx-n
Spiral Matrix	spiral-matrix
Merge Intervals	merge-intervals
Insert Interval	insert-interval
Plus One	plus-one
Longest Consecutive Sequence	longest-consecutive-sequence
Clone Graph	clone-graph
Word Break	word-break
Word Break II	word-break-ii
LRU Cache	lru-cache
Min Stack	min-stack
Read N Characters Given Read4 II - Call multiple times	read-n-characters-given-read4-ii-call-multiple-times
Longest Substring with At Most Two Distinct Characters	longest-substring-with-at-most-two-distinct-characters
Find Peak Element	find-peak-element
Missing Ranges	missing-ranges
Fraction to Recurring Decimal	fraction-to-recurring-decimal
Binary Search Tree Iterator	binary-search-tree-iterator
Number of Islands	number-of-islands
Implement Trie (Prefix Tree)	implement-trie-prefix-tree
Word Search II	word-search-ii
Shortest Palindrome	shortest-palindrome
The Skyline Problem	the-skyline-problem
Basic Calculator	basic-calculator
Summary Ranges	summary-ranges
Kth Smallest Element in a BST	kth-smallest-element-in-a-bst
Power of Two	power-of-two
Sliding Window Maximum	sliding-window-maximum
Search a 2D Matrix II	search-a-2d-matrix-ii
Strobogrammatic Number	strobogrammatic-number
Strobogrammatic Number II	strobogrammatic-number-ii
Group Shifted Strings	group-shifted-strings
Flatten 2D Vector	flatten-2d-vector
Meeting Rooms II	meeting-rooms-ii
Binary Tree Paths	binary-tree-paths
3Sum Smaller	3sum-smaller
Graph Valid Tree	graph-valid-tree
Palindrome Permutation	palindrome-permutation
Alien Dictionary	alien-dictionary
Closest Binary Search Tree Value	closest-binary-search-tree-value
Encode and Decode Strings	encode-and-decode-strings
Closest Binary Search Tree Value II	closest-binary-search-tree-value-ii
H-Index	h-index
Paint Fence	paint-fence
Perfect Squares	perfect-squares
Wiggle Sort	wiggle-sort
Zigzag Iterator	zigzag-iterator
Expression Add Operators	expression-add-operators
Peeking Iterator	peeking-iterator
Walls and Gates	walls-and-gates
Unique Word Abbreviation	unique-word-abbreviation
Game of Life	game-of-life
Flip Game	flip-game
Flip Game II	flip-game-ii
Find Median from Data Stream	find-median-from-data-stream
Serialize and Deserialize Binary Tree	serialize-and-deserialize-binary-tree
Binary Tree Longest Consecutive Sequence	binary-tree-longest-consecutive-sequence
Smallest Rectangle Enclosing Black Pixels	smallest-rectangle-enclosing-black-pixels
Number of Islands II	number-of-islands-ii
Range Sum Query 2D - Mutable	range-sum-query-2d-mutable
Best Time to Buy and Sell Stock with Cooldown	best-time-to-buy-and-sell-stock-with-cooldown
Minimum Height Trees	minimum-height-trees
Burst Balloons	burst-balloons
Super Ugly Number	super-ugly-number
Binary Tree Vertical Order Traversal	binary-tree-vertical-order-traversal
Count of Smaller Numbers After Self	count-of-smaller-numbers-after-self
Remove Duplicate Letters	remove-duplicate-letters
Shortest Distance from All Buildings	shortest-distance-from-all-buildings
Maximum Product of Word Lengths	maximum-product-of-word-lengths
Generalized Abbreviation	generalized-abbreviation
Create Maximum Number	create-maximum-number
Number of Connected Components in an Undirected Graph	number-of-connected-components-in-an-undirected-graph
Wiggle Sort II	wiggle-sort-ii
Power of Three	power-of-three
Count of Range Sum	count-of-range-sum
Longest Increasing Path in a Matrix	longest-increasing-path-in-a-matrix
Patching Array	patching-array
Verify Preorder Serialization of a Binary Tree	verify-preorder-serialization-of-a-binary-tree
Reconstruct Itinerary	reconstruct-itinerary
Palindrome Pairs	palindrome-pairs
Longest Substring with At Most K Distinct Characters	longest-substring-with-at-most-k-distinct-characters
Flatten Nested List Iterator	flatten-nested-list-iterator
Reverse Vowels of a String	reverse-vowels-of-a-string
Moving Average from Data Stream	moving-average-from-data-stream
Design Tic-Tac-Toe	design-tic-tac-toe
Android Unlock Patterns	android-unlock-patterns
Design Snake Game	design-snake-game
Russian Doll Envelopes	russian-doll-envelopes
Line Reflection	line-reflection
Count Numbers with Unique Digits	count-numbers-with-unique-digits
Rearrange String k Distance Apart	rearrange-string-k-distance-apart
Logger Rate Limiter	logger-rate-limiter
Sort Transformed Array	sort-transformed-array
Bomb Enemy	bomb-enemy
Design Hit Counter	design-hit-counter
Max Sum of Rectangle No Larger Than K	max-sum-of-rectangle-no-larger-than-k
Largest Divisible Subset	largest-divisible-subset
Plus One Linked List	plus-one-linked-list
Range Addition	range-addition
Find K Pairs with Smallest Sums	find-k-pairs-with-smallest-sums
Guess Number Higher or Lower	guess-number-higher-or-lower
Guess Number Higher or Lower II	guess-number-higher-or-lower-ii
Combination Sum IV	combination-sum-iv
Kth Smallest Element in a Sorted Matrix	kth-smallest-element-in-a-sorted-matrix
Design Phone Directory	design-phone-directory
Insert Delete GetRandom O(1)	insert-delete-getrandom-o1
Linked List Random Node	linked-list-random-node
Longest Absolute File Path	longest-absolute-file-path
Find the Difference	find-the-difference
Perfect Rectangle	perfect-rectangle
UTF-8 Validation	utf-8-validation
Decode String	decode-string
Integer Replacement	integer-replacement
Evaluate Division	evaluate-division
Nth Digit	nth-digit
Binary Watch	binary-watch
Remove K Digits	remove-k-digits
Queue Reconstruction by Height	queue-reconstruction-by-height
Trapping Rain Water II	trapping-rain-water-ii
Valid Word Abbreviation	valid-word-abbreviation
Longest Palindrome	longest-palindrome
Minimum Unique Word Abbreviation	minimum-unique-word-abbreviation
Add Strings	add-strings
Pacific Atlantic Water Flow	pacific-atlantic-water-flow
Sentence Screen Fitting	sentence-screen-fitting
Maximum XOR of Two Numbers in an Array	maximum-xor-of-two-numbers-in-an-array
Valid Word Square	valid-word-square
Word Squares	word-squares
Sequence Reconstruction	sequence-reconstruction
Number of Boomerangs	number-of-boomerangs
Find All Numbers Disappeared in an Array	find-all-numbers-disappeared-in-an-array
Sort Characters By Frequency	sort-characters-by-frequency
Repeated Substring Pattern	repeated-substring-pattern
LFU Cache	lfu-cache
Island Perimeter	island-perimeter
Optimal Account Balancing	optimal-account-balancing
Convex Polygon	convex-polygon
Encode String with Shortest Length	encode-string-with-shortest-length
Ones and Zeroes	ones-and-zeroes
Heaters	heaters
Sliding Window Median	sliding-window-median
Magical String	magical-string
License Key Formatting	license-key-formatting
Smallest Good Base	smallest-good-base
Find Permutation	find-permutation
Max Consecutive Ones	max-consecutive-ones
Predict the Winner	predict-the-winner
Max Consecutive Ones II	max-consecutive-ones-ii
The Maze	the-maze
Reverse Pairs	reverse-pairs
Target Sum	target-sum
Diagonal Traverse	diagonal-traverse
Find Mode in Binary Search Tree	find-mode-in-binary-search-tree
Next Greater Element II	next-greater-element-ii
The Maze II	the-maze-ii
Relative Ranks	relative-ranks
Freedom Trail	freedom-trail
Detect Capital	detect-capital
Longest Uncommon Subsequence I	longest-uncommon-subsequence-i
Longest Uncommon Subsequence II	longest-uncommon-subsequence-ii
Longest Word in Dictionary through Deleting	longest-word-in-dictionary-through-deleting
Beautiful Arrangement	beautiful-arrangement
Word Abbreviation	word-abbreviation
Minimum Absolute Difference in BST	minimum-absolute-difference-in-bst
Lonely Pixel I	lonely-pixel-i
Lonely Pixel II	lonely-pixel-ii
Encode and Decode TinyURL	encode-and-decode-tinyurl
Reverse String II	reverse-string-ii
01 Matrix	01-matrix
Diameter of Binary Tree	diameter-of-binary-tree
Output Contest Matches	output-contest-matches
Boundary of Binary Tree	boundary-of-binary-tree
Binary Tree Longest Consecutive Sequence II	binary-tree-longest-consecutive-sequence-ii
Student Attendance Record I	student-attendance-record-i
Student Attendance Record II	student-attendance-record-ii
Subarray Sum Equals K	subarray-sum-equals-k
Longest Line of Consecutive One in Matrix	longest-line-of-consecutive-one-in-matrix
Maximum Vacation Days	maximum-vacation-days
Median Employee Salary	median-employee-salary
Shortest Unsorted Continuous Subarray	shortest-unsorted-continuous-subarray
Delete Operation for Two Strings	delete-operation-for-two-strings
587	Erect the Fence	erect-the-fence
Design Compressed String Iterator	design-compressed-string-iterator
Add Bold Tag in String	add-bold-tag-in-string
Shopping Offers	shopping-offers
Maximum Average Subarray I	maximum-average-subarray-i
Maximum Average Subarray II	maximum-average-subarray-ii
4 Keys Keyboard	4-keys-keyboard
Find Duplicate Subtrees	find-duplicate-subtrees
Coin Path	coin-path
Judge Route Circle	judge-route-circle
Find K Closest Elements	find-k-closest-elements
Split Array into Consecutive Subsequences	split-array-into-consecutive-subsequences
Non-decreasing Array	non-decreasing-array
Beautiful Arrangement II	beautiful-arrangement-ii
Kth Smallest Number in Multiplication Table	kth-smallest-number-in-multiplication-table
Implement Magic Dictionary	implement-magic-dictionary
24 Game	24-game
Next Closest Time	next-closest-time
K Empty Slots	k-empty-slots
Redundant Connection	redundant-connection
685	Redundant Connection II	redundant-connection-ii
Maximum Sum of 3 Non-Overlapping Subarrays	maximum-sum-of-3-non-overlapping-subarrays
Longest Univalue Path	longest-univalue-path
Repeated String Match	repeated-string-match
Find K-th Smallest Pair Distance	find-k-th-smallest-pair-distance
Minimum Window Subsequence	minimum-window-subsequence
Number of Atoms	number-of-atoms
My Calendar I	my-calendar-i
My Calendar II	my-calendar-ii
My Calendar III	my-calendar-iii
Sentence Similarity	sentence-similarity
Sentence Similarity II	sentence-similarity-ii
Daily Temperatures	daily-temperatures
First Unique Character in a String	first-unique-character-in-a-string
Shortest Completing Word	shortest-completing-word
Largest Number At Least Twice of Others	largest-number-at-least-twice-of-others
Cracking the Safe	cracking-the-safe
Pyramid Transition Matrix	pyramid-transition-matrix
Bold Words in String	bold-words-in-string
Find Anagram Mappings	find-anagram-mappings
Couples Holding Hands	couples-holding-hands
Max Chunks To Make Sorted	max-chunks-to-make-sorted
Max Chunks To Make Sorted II	max-chunks-to-make-sorted-ii
Toeplitz Matrix	toeplitz-matrix
Minimize Max Distance to Gas Station	minimize-max-distance-to-gas-station
Swap Adjacent in LR String	swap-adjacent-in-lr-string
Swim in Rising Water	swim-in-rising-water
K-th Symbol in Grammar	k-th-symbol-in-grammar
Transform to Chessboard	transform-to-chessboard
Minimum Distance Between BST Nodes	minimum-distance-between-bst-nodes
Rotated Digits	rotated-digits
Escape The Ghosts	escape-the-ghosts
Domino and Tromino Tiling	domino-and-tromino-tiling
Number of Matching Subsequences	number-of-matching-subsequences
Reaching Points	reaching-points
Similar RGB Color	similar-rgb-color
Find Eventual Safe States	find-eventual-safe-states
Bricks Falling When Hit	bricks-falling-when-hit
Soup Servings	soup-servings
Expressive Words	expressive-words
Largest Triangle Area	largest-triangle-area
Largest Sum of Averages	largest-sum-of-averages
Bus Routes	bus-routes
Race Car	race-car
Linked List Components	linked-list-components
Ambiguous Coordinates	ambiguous-coordinates
Positions of Large Groups	positions-of-large-groups
Flipping an Image	flipping-an-image
Find And Replace in String	find-and-replace-in-string
Sum of Distances in Tree	sum-of-distances-in-tree
Image Overlap	image-overlap
New 21 Game	new-21-game
Push Dominoes	push-dominoes
Similar String Groups	similar-string-groups
Bulls and Cows	bulls-and-cows
Magic Squares In Grid	magic-squares-in-grid
Keys and Rooms	keys-and-rooms
Guess the Word	guess-the-word
Shortest Path Visiting All Nodes	shortest-path-visiting-all-nodes
Longest Mountain in Array	longest-mountain-in-array
Backspace String Compare	backspace-string-compare
Maximize Distance to Closest Person	maximize-distance-to-closest-person
Peak Index in a Mountain Array	peak-index-in-a-mountain-array
Exam Room	exam-room
K-Similar Strings	k-similar-strings
Car Fleet	car-fleet
Minimum Cost to Hire K Workers	minimum-cost-to-hire-k-workers
Buddy Strings	buddy-strings